0 0 0 0 0 0 0 0 0 0 0 0 0 0 0 0 0 0 0 0 
0 0 0 0 0 0 0 0 0 0 0 0 0 0 0 0 0 0 0 0 
0 0 0 0 0 0 0 0 1 1 1 1 1 1 1 0 0 0 0 0 
0 0 0 0 0 0 0 1 2 2 2 2 2 2 2 1 0 0 0 0 
0 0 0 0 0 0 1 2 2 2 2 1 1 1 1 1 0 0 0 0 
0 0 0 0 0 0 1 2 2 2 1 3 3 5 5 5 1 0 0 0 
0 0 0 0 0 0 1 2 2 1 3 3 3 3 3 3 5 1 0 0 
0 0 0 0 1 1 1 2 2 1 3 3 3 3 3 3 3 1 0 0 
0 0 0 1 2 2 1 2 2 2 1 3 3 3 3 3 3 1 0 0 
0 0 0 1 2 2 1 2 2 2 2 1 1 1 1 1 1 0 0 0 
0 0 0 1 2 2 1 2 2 2 2 2 2 2 2 2 1 0 0 0 
0 0 0 1 2 2 1 2 2 2 2 2 2 2 2 2 1 0 0 0 
0 0 0 1 2 2 1 2 2 2 2 2 2 2 2 2 1 0 0 0 
0 0 0 0 1 1 1 2 2 2 2 2 2 2 2 2 1 0 0 0 
0 0 0 0 0 0 1 2 2 2 1 1 1 1 2 2 1 0 0 0 
0 0 0 0 0 0 1 2 2 2 1 0 0 1 2 2 1 0 0 0 
0 0 0 0 0 0 1 2 2 2 1 0 0 1 2 2 1 0 0 0 
0 0 0 0 0 0 0 1 1 1 0 0 0 0 1 1 0 0 0 0 
0 0 0 0 0 0 0 0 0 0 0 0 0 0 0 0 0 0 0 0 
0 0 0 0 0 0 0 0 0 0 0 0 0 0 0 0 0 0 0 0 
