0 0 0 3 1 1 1 1 1 2 1 1 1 1 1 3 0 0 0 0 
0 0 0 3 1 1 1 1 1 2 1 1 1 1 1 3 0 0 0 0 
0 0 0 3 3 1 1 1 1 2 1 1 1 1 3 3 0 0 0 0 
0 0 0 3 3 3 3 3 1 2 1 3 3 3 3 3 0 0 0 0 
0 0 0 0 0 0 0 3 1 2 1 3 0 0 0 0 0 0 0 0 
0 0 0 0 0 0 0 3 1 2 1 3 0 0 0 0 0 0 0 0 
0 0 0 0 0 0 0 3 1 2 1 3 0 0 0 0 0 0 0 0 
0 0 0 0 0 0 0 3 3 2 3 3 0 0 0 0 0 0 0 0 
0 0 0 0 0 0 0 0 3 2 3 0 0 0 0 0 0 0 0 0 
0 0 0 0 0 0 0 0 3 2 3 0 0 0 0 0 0 0 0 0 
0 0 0 0 0 0 0 0 3 2 3 0 0 0 0 0 0 0 0 0 
0 0 0 0 0 0 0 0 3 2 3 0 0 0 0 0 0 0 0 0 
0 0 0 0 0 0 0 0 3 2 3 0 0 0 0 0 0 0 0 0 
0 0 0 0 0 0 0 0 3 2 3 0 0 0 0 0 0 0 0 0 
0 0 0 0 0 0 0 0 3 2 3 0 0 0 0 0 0 0 0 0 
0 0 0 0 0 0 0 0 3 2 3 0 0 0 0 0 0 0 0 0 
0 0 0 0 0 0 0 0 3 2 3 0 0 0 0 0 0 0 0 0 
0 0 0 0 0 0 0 0 3 2 3 0 0 0 0 0 0 0 0 0 
0 0 0 0 0 0 0 0 5 2 5 0 0 0 0 0 0 0 0 0 
0 0 0 0 0 0 0 0 5 5 5 0 0 0 0 0 0 0 0 0 
