0 1 1 0 0 0 0 0 1 1 0 0 0 0 0 0 0 0 0 0 
0 1 1 1 0 0 0 1 1 1 1 0 0 1 1 0 0 0 0 1 
1 0 0 1 1 0 1 1 0 0 1 0 0 1 0 1 0 0 1 0 
1 0 0 0 1 1 1 0 0 0 1 1 1 1 0 1 1 1 1 0 
1 0 0 0 0 0 0 0 0 0 0 0 0 0 0 0 1 1 0 0 
1 4 4 1 2 4 2 2 2 4 2 3 4 4 3 5 5 5 5 5 
4 1 1 4 2 4 2 2 2 4 2 4 3 3 4 5 5 5 5 5 
4 1 1 4 2 4 2 2 2 4 2 4 3 3 4 5 5 5 5 5 
4 1 1 4 2 4 2 4 2 4 2 4 3 3 4 5 5 5 5 5 
4 1 1 4 2 4 2 4 2 4 2 4 3 3 4 5 5 5 5 5 
4 1 1 4 2 4 2 4 2 4 2 4 3 3 4 5 5 5 5 5 
4 1 1 4 2 4 2 4 2 4 2 4 3 3 4 5 5 5 5 5 
4 1 1 4 2 4 2 4 2 4 2 4 3 3 4 5 5 5 5 5 
4 1 1 4 2 2 4 2 4 2 2 4 3 3 4 5 5 5 5 5 
1 4 4 1 2 2 2 2 2 2 2 3 4 4 3 5 5 5 5 5 
1 0 0 1 0 1 0 0 0 1 0 1 0 0 1 0 0 0 0 0 
1 1 1 1 0 1 1 1 1 1 0 1 1 1 1 0 0 0 0 0 
0 0 0 0 0 0 0 0 0 0 0 0 0 0 0 0 0 0 0 0 
0 0 0 0 0 0 0 0 0 0 0 0 0 0 0 0 0 0 0 0 
0 0 0 0 0 0 0 0 0 0 0 0 0 0 0 0 0 0 0 0 
