0 0 0 0 0 0 0 0 0 0 0 0 0 0 0 0 0 0 0 0 
0 0 0 0 0 5 0 0 0 0 5 0 0 5 0 5 5 0 5 0 
0 5 0 0 0 0 0 0 0 0 0 0 0 0 0 0 0 0 0 0 
0 0 5 0 5 0 5 0 0 5 0 5 0 5 0 5 0 5 0 5 
5 0 0 0 0 0 0 0 0 0 0 0 0 0 0 0 0 0 0 0 
0 0 0 0 0 0 0 0 0 0 0 0 0 0 0 0 0 0 0 0 
1 4 4 1 3 4 4 3 3 4 4 3 3 3 4 4 2 2 2 2 
4 1 1 4 3 3 4 3 3 3 4 3 3 4 2 2 4 2 2 2 
4 1 1 4 3 3 4 3 3 3 4 3 3 4 2 2 4 2 2 2 
4 1 1 4 3 3 4 3 3 3 4 3 3 4 2 2 4 2 2 2 
4 1 1 4 3 3 4 3 3 3 4 3 3 4 2 2 4 2 2 2 
4 1 1 4 3 3 4 3 3 3 4 3 3 4 2 2 4 2 2 2 
4 1 1 4 3 3 4 3 3 3 4 3 3 4 2 2 4 2 2 2 
4 1 1 4 3 3 4 3 3 3 4 3 3 4 2 2 4 2 2 2 
4 1 1 4 3 3 4 3 3 3 4 3 3 4 2 2 4 2 2 2 
1 4 4 1 3 4 4 4 3 4 4 4 3 3 4 4 2 2 2 2 
0 0 5 0 0 0 5 0 0 0 5 0 0 0 5 0 0 5 0 5 
0 0 0 0 0 0 0 0 0 0 0 0 0 0 0 0 0 0 0 0 
0 0 0 0 0 0 0 0 0 0 0 0 0 0 0 0 0 0 0 0 
0 0 0 0 0 0 0 0 0 0 0 0 0 0 0 0 0 0 0 0 
